5
6
# # # # # #
# 2 3 + + #
# . . - - #
# 1 1 # # #
# # # # # #