14
12
# # # # # # # # # # # #
# + - + 1 4 1 4 1 2 4 #
# 8 1 2 1 4 1 4 1 2 4 1
# 0 - 1 1 4 1 4 1 2 4 1
# 0 - 1 1 4 1 4 1 2 4 #
# 0 - 1 1 4 1 4 1 2 4 #
# 0 - 1 1 4 1 4 1 2 4 #
# 0 - 1 1 4 1 4 1 2 4 #
# 0 - 1 1 4 1 4 1 2 4 #
# 0 - 1 1 4 1 4 1 2 4 #
# 0 - 1 1 4 1 4 1 2 4 #
# 0 - 1 1 4 1 4 1 2 4 #
# 0 - 1 1 4 1 4 1 2 4 #
# # # # # # # # # # # #